111111111111111111111111111111111111111111111111111111111111
1P0000000000000000000000000000000000000010000000001000000001
100001000X000000000000000000000000000000100000C00010000C0001
10000100000000000000000000X000000000000000000000001110000001
110000100000000000000000000000000000000000001111111000000001
100001000000000000000000000000000000000000000000000000000001
1000011110000000000000000000C000000000X000000000000000000001
100000000000000000000000000000000000000000000000000X00000001
100000000000000000000000000000000000000000000000000000000001
100000000000000000000000111000000000000000000010000000000001
10000000X000000000000000110000000000000000000010000000000001
10000000000000000000000000100000000X000000000010000000000001
100000000000000000000000000100000000000000000010000000000001
100000000000000000000000011100000000000000000000000000000001
1000000C00000000000000000000000X0000000000000000000C00000001
100000000000000000000000000000000000000000000000000000000001
100000000000000100000000000000000000000000000000000000000001
100000000000001110000000000000000000000000000000011100000001
100000000000000100000000000000000000000000000000000000000001
100000000000000000000000000000000000110000000000000000000001
10000X00000000000000000000000000000000C000000000000000000001
1000000000000000000000000000000000000000000000000000X0000001
100000000000000000000000000000000000000000000000000000000001
100000000000000000010000000000000000000000000000000000000001
10000000000000000001000000000X000000000000000X00000000000001
1000000000X0000000010000000000000000000000000000000000000001
111110000000000000000000000000000000000000000000000000011111
100000000000001110000000000000000000000000000X00000000000001
10000C000000000001000000000000000000000000000000000000100001
10000000000000000010000000000C0000000000000000000000001000E1
111111111111111111111111111111111111111111111111111111111111
