11111111111111
100000000000C1
10000000000011
1CC00000001001
1P000000001001
11111111111111
