11111111111111
10000000000001
10000000000011
10000000001001
1P000000001E01
11111111111111
