111111111111111111111111111111111
1C00011000011111111100000000000C1
111000001000000000000000011011111
1E1111111000001110001111111011111
100011C00001110000000000111011111
1100001110011111011110011P0011111
100111110011100001111111111111111
100000110111111100000011000111111
110C10000011111110011000010C11111
111111111111111111111111111111111
