111111111111111111111111111111
100X000000011110000000001110E1
10001110000000C000000111100001
100000110000000000X00000000001
100000000000000000000001100001
1P0000011000000000011111100001
100000110000000111110000011101
1000000110000C100000000X000001
100X00011100111000000000000001
100000011000000000000010000001
111110111111010011111111111111
100000000000000000000000000001
111111111111111111111111111111
